TILEMAP
20 15 							-- Size of tile map in tiles
32 32 							-- Tile size & block size
images/tiles.png 	-- Tilesheet
6 4 								-- Number of tiles in tilesheet
-1 -1 -1 -1 -1 -1 -1 -1 -1 -1 -1 -1 -1 -1 -1 -1 -1 -1 -1 -1
-1 -1 -1 -1 -1 -1 -1 -1 -1 -1 -1 -1 -1 -1 -1 -1 -1 -1 -1 -1
-1 -1 -1 -1 -1 -1 -1 -1 -1 -1 -1 -1 -1 -1 -1 -1 -1 -1 -1 -1
1 1 2 -1 -1 -1 -1 -1 -1 -1 -1 -1 -1 -1 -1 -1 -1 -1 -1 -1
9 10 -1 -1 -1 -1 13 -1 -1 -1 -1 -1 -1 -1 -1 -1 -1 -1 -1 -1
9 10 4 -1 -1 -1 -1 -1 -1 -1 -1 -1 -1 -1 -1 -1 -1 -1 -1 11
9 10 0 1 1 1 -1 -1 -1 -1 -1 -1 -1 0 1 1 -1 -1 9 10
-1 -1 -1 -1 -1 4 -1 -1 -1 -1 -1 -1 -1 -1 9 10 -1 -1 3 7
-1 -1 -1 -1 -1 6 -1 -1 -1 -1 -1 -1 -1 -1 3 3 -1 -1 3 8
-1 -1 -1 -1 -1 -1 -1 -1 -1 -1 -1 -1 -1 -1 9 10 -1 -1 9 10
-1 -1 -1 -1 -1 -1 -1 -1 -1 -1 -1 -1 -1 -1 -1 -1 -1 -1 4 4
-1 -1 -1 -1 -1 -1 -1 -1 -1 -1 -1 -1 -1 -1 -1 -1 -1 -1 9 10
-1 -1 -1 -1 -1 -1 -1 -1 -1 -1 -1 -1 -1 -1 -1 0 1 2 6 6
0 1 2 -1 -1 -1 -1 0 1 2 -1 -1 -1 -1 -1 -1 -1 -1 6 6
17 17 17 17 17 17 17 17 17 17 17 17 17 17 17 17 17 17 17 17
