TILEMAP
20 15 							-- Size of tile map in tiles
32 32 							-- Tile size & block size
images/tiles.png 	-- Tilesheet
6 4 								-- Number of tiles in tilesheet
-1 -1 -1 -1 -1 -1 -1 -1 -1 -1 -1 -1 -1 -1 -1 -1 -1 -1 -1 -1
-1 -1 -1 -1 -1 -1 -1 -1 -1 -1 -1 -1 -1 -1 -1 -1 -1 -1 -1 -1
-1 -1 -1 -1 -1 -1 -1 -1 -1 -1 -1 -1 -1 -1 -1 -1 -1 -1 -1 -1
-1 -1 -1 -1 -1 -1 -1 -1 -1 -1 -1 -1 -1 -1 -1 -1 -1 -1 -1 -1
-1 -1 -1 -1 -1 -1 -1 -1 -1 -1 -1 -1 -1 -1 -1 -1 -1 -1 -1 -1
-1 -1 -1 -1 -1 -1 -1 -1 -1 -1 -1 -1 -1 -1 -1 -1 1 1 1 1
11 -1 -1 -1 -1 -1 0 1 1 1 1 1 -1 -1 -1 -1 7 3 7 9
1 1 1 1 1 -1 -1 9 10 3 10 9 -1 -1 -1 -1 8 3 8 9
9 10 9 10 9 -1 -1 6 10 9 10 6 -1 -1 -1 -1 10 9 10 9
9 7 9 7 9 -1 -1 9 7 9 7 9 -1 -1 -1 -1 7 9 7 9
9 8 9 8 9 -1 -1 9 8 9 8 9 -1 -1 -1 -1 8 9 8 9
9 10 4 10 9 -1 -1 6 10 4 10 6 -1 -1 -1 -1 10 4 10 9
9 3 9 3 9 -1 -1 9 3 9 3 9 -1 -1 -1 -1 3 9 3 9
9 10 9 10 9 -1 -1 9 10 9 10 9 -1 -1 -1 -1 10 9 10 9
9 7 9 7 9 17 17 9 7 9 7 9 17 17 17 17 7 9 7 9
