TILEMAP
20 15 							-- Size of tile map in tiles
32 32 							-- Tile size & block size
images/tiles.png 	-- Tilesheet
6 4 								-- Number of tiles in tilesheet
4    3    4    3    4    3    4    3    4    3    4    3    4    3    4    3    4    3    4    7
10   -1   -1   -1   -1   -1   -1   -1   -1   -1   -1   -1   -1   -1   -1   -1   -1   -1   -1   8
10   -1   -1   -1   -1   -1   -1   -1   -1   -1   -1   -1   -1   -1   -1   -1   -1   -1   -1   10
10   -1   11   -1   -1   -1   -1   -1   -1   -1   -1   -1   -1   -1   -1   -1   -1   -1   -1   10
10    0    1    1    1    1   2   -1   -1   -1   -1   -1   -1   -1   -1   -1   -1   -1   -1   10
10    9   10    9   10    9   10   -1   -1   -1   -1    0    1    1    2   -1   -1   -1   -1   10
10   -1   -1   -1   -1   -1   -1   -1   -1   -1   -1   -1   -1   -1   -1   -1   -1   -1   -1   10
10   -1   -1   -1   -1   -1   -1   -1   -1   -1   -1   -1   -1   -1   -1   -1   -1   -1   -1   10
10   -1   -1    0    1    1    1    1    2   -1   -1   -1   -1   -1   -1   -1   -1   -1    9    4
10   -1   -1   -1   -1   -1   -1   -1   -1   -1   -1   -1   -1   -1   -1   -1   -1   -1    9   10
10   -1   -1   -1   -1   -1   -1   -1   -1   -1   -1   -1   -1   -1   -1   -1   -1   -1    9   10
10   -1   -1   -1   -1   -1   -1   -1   -1   -1   -1   -1   11   -1   -1   13   -1   -1    9   10
10   -1   -1   -1   -1   -1   -1   -1   -1   -1   -1   -1    0    1    1    2   -1   -1    9   10
10   17   17   17   17   17   17   17   17   17   17   17   17   17   17   17   17   17    9    7
10    9   10    9   10    9   10    9   10    9   10    9   10    9   10    9    9   10    9    8
