TILEMAP
20 15 							-- Size of tile map in tiles
32 32 							-- Tile size & block size
images/tiles.png 	-- Tilesheet
6 4 								-- Number of tiles in tilesheet
9 -1 -1 -1 -1 -1 -1 -1 -1 -1 -1 -1 -1 -1 -1 -1 -1 -1 -1 -1
9 -1 -1 -1 -1 -1 -1 -1 -1 -1 -1 -1 -1 -1 -1 -1 -1 -1 -1 -1
9 -1 -1 -1 -1 0 1 1 1 2 -1 0 1 1 1 1 -1 -1 0 1
9 -1 -1 -1 -1 -1 -1 -1 -1 -1 -1 -1 4 6 4 4 -1 -1 -1 10
9 2 -1 -1 -1 -1 -1 -1 -1 -1 -1 17 9 10 9 10 -1 -1 -1 10
9 -1 -1 -1 0 1 2 -1 -1 -1 -1 -1 -1 -1 -1 -1 -1 -1 -1 10
9 -1 -1 -1 -1 -1 -1 -1 -1 -1 -1 -1 -1 -1 -1 -1 -1 -1 -1 10
1 2 -1 -1 -1 -1 -1 -1 -1 -1 -1 -1 -1 -1 -1 -1 -1 -1 -1 10
9 -1 -1 -1 -1 -1 -1 -1 -1 -1 -1 -1 -1 -1 -1 -1 -1 -1 -1 10
9 11 -1 -1 -1 -1 -1 -1 -1 -1 -1 -1 -1 -1 -1 -1 -1 -1 -1 10
1 1 1 1 2 -1 -1 -1 -1 -1 -1 -1 -1 -1 -1 -1 -1 -1 -1 10
10 9 10 9 -1 -1 -1 -1 -1 -1 -1 -1 -1 -1 -1 -1 -1 -1 -1 10
10 9 10 9 -1 -1 -1 1 1 1 -1 -1 -1 -1 -1 -1 -1 -1 -1 10
10 9 10 9 11 -1 -1 10 7 9 6 6 -1 -1 11 -1 -1 11 -1 10
10 9 10 9 17 17 17 10 8 9 17 17 17 17 17 17 17 17 17 17
