TILEMAP
20 15 							-- Size of tile map in tiles
32 32 							-- Tile size & block size
images/tiles.png 	-- Tilesheet
6 4 								-- Number of tiles in tilesheet
-1 -1 -1 -1 -1 -1 -1 -1 -1 -1 -1 -1 -1 -1 -1 -1 -1 -1 -1 -1
-1 -1 -1 -1 -1 -1 -1 -1 -1 -1 -1 -1 -1 -1 -1 -1 -1 -1 -1 -1
1 1 2 -1 -1 -1 -1 -1 -1 -1 -1 -1 -1 -1 -1 -1 -1 -1 -1 -1
7 10 -1 -1 -1 -1 -1 -1 -1 -1 -1 -1 -1 -1 -1 -1 -1 -1 -1 -1
8 10 -1 -1 -1 -1 13 -1 -1 -1 -1 -1 -1 -1 -1 -1 -1 -1 -1 -1
-1 -1 -1 -1 -1 -1 1 -1 -1 -1 -1 -1 -1 -1 -1 -1 -1 -1 -1 -1
-1 -1 -1 -1 -1 -1 4 -1 -1 0 1 2 -1 -1 -1 -1 -1 0 1 1
-1 -1 -1 -1 -1 -1 9 -1 -1 -1 10 5 -1 -1 -1 -1 -1 -1 10 7
-1 -1 -1 -1 -1 -1 9 2 -1 -1 10 5 -1 -1 -1 -1 -1 -1 10 8
-1 -1 1 1 -1 -1 -1 -1 -1 -1 10 5 -1 -1 -1 -1 -1 -1 10 3
-1 -1 9 6 -1 -1 -1 -1 -1 -1 10 5 -1 -1 -1 -1 -1 -1 10 7
-1 -1 9 4 -1 -1 -1 -1 -1 -1 10 5 -1 -1 -1 -1 -1 -1 10 8
1 1 1 1 2 -1 -1 1 1 1 10 5 -1 -1 -1 -1 -1 -1 10 3
9 7 3 2 -1 -1 -1 9 10 9 10 5 -1 -1 -1 -1 -1 -1 10 7
9 8 2 12 17 17 17 9 10 9 10 5 17 17 17 17 17 9 10 8
