TILEMAP
20 15 							-- Size of tile map in tiles
32 32 							-- Tile size & block size
images/tiles.png 	-- Tilesheet
6 4 								-- Number of tiles in tilesheet
-1 -1 -1 -1 -1 -1 -1 -1 -1 -1 -1 -1 -1 -1 -1 -1 -1 -1 -1 -1
-1 -1 -1 -1 -1 -1 -1 -1 -1 -1 -1 -1 -1 -1 -1 -1 -1 -1 -1 -1
-1 -1 -1 -1 -1 -1 -1 -1 -1 -1 -1 -1 -1 -1 -1 -1 -1 -1 -1 -1
-1 -1 -1 -1 -1 -1 -1 -1 -1 1 1 2 -1 -1 -1 -1 -1 -1 -1 -1
1 1 1 1 -1 -1 -1 -1 -1 3 3 5 -1 -1 -1 -1 -1 -1 -1 -1
9 7 4 10 -1 -1 -1 -1 -1 9 10 5 -1 -1 -1 -1 -1 -1 -1 -1
9 8 3 10 -1 -1 -1 -1 -1 3 3 5 -1 -1 -1 -1 -1 -1 -1 -1
6 6 6 6 17 17 17 17 17 9 10 12 -1 -1 -1 -1 -1 -1 -1 -1
9 9 9 9 9 9 9 9 10 9 10 12 -1 -1 -1 -1 -1 -1 -1 11
9 9 9 9 9 9 9 10 4 9 10 -1 -1 -1 -1 -1 -1 -1 1 1
-1 -1 -1 -1 -1 -1 -1 -1 -1 -1 -1 -1 -1 -1 -1 -1 -1 -1 9 10
-1 -1 -1 -1 -1 -1 -1 -1 -1 -1 -1 -1 -1 -1 -1 -1 -1 -1 -1 -1
-1 -1 -1 -1 -1 -1 -1 -1 -1 -1 -1 -1 -1 -1 -1 -1 -1 -1 -1 -1
-1 -1 -1 -1 -1 0 1 1 1 2 -1 -1 -1 -1 -1 -1 -1 -1 -1 -1
17 17 17 17 17 17 17 17 17 17 17 17 17 17 17 17 17 17 17 17
