TILEMAP
20 15 							-- Size of tile map in tiles
32 32 							-- Tile size & block size
images/tiles.png 	-- Tilesheet
6 4 								-- Number of tiles in tilesheet
-1 -1 -1 -1 9 10 5 -1 -1 -1 -1 -1 -1 -1 -1 -1 -1 4 -1 4
-1 -1 -1 -1 9 10 5 -1 -1 -1 -1 -1 -1 -1 -1 -1 -1 9 -1 10
-1 -1 -1 -1 9 10 5 -1 -1 -1 -1 -1 -1 -1 -1 -1 -1 4 -1 4
0 2 -1 -1 9 10 5 -1 -1 -1 -1 -1 -1 -1 -1 -1 -1 -1 -1 10
9 10 -1 -1 9 10 -1 -1 -1 -1 -1 -1 -1 -1 -1 -1 -1 -1 -1 10
9 10 -1 -1 9 10 -1 -1 -1 -1 -1 -1 -1 -1 -1 -1 -1 -1 -1 -1
9 10 -1 -1 -1 -1 -1 -1 -1 -1 -1 -1 0 2 -1 -1 -1 0 2 -1
9 10 -1 -1 -1 -1 -1 -1 -1 -1 -1 -1 9 10 17 17 17 17 17 17
9 10 -1 -1 -1 -1 -1 -1 -1 -1 -1 -1 9 10 9 10 9 10 9 10
9 10 -1 -1 -1 -1 -1 -1 -1 -1 -1 -1 9 10 9 10 9 10 9 10
9 10 -1 -1 11 -1 -1 -1 -1 -1 -1 -1 7 10 7 10 7 10 7 10
9 10 -1 0 1 1 2 -1 -1 -1 -1 -1 8 10 8 10 8 10 8 10
9 10 -1 -1 9 10 -1 -1 -1 -1 -1 -1 9 10 9 10 9 10 9 10
9 10 -1 -1 9 10 -1 -1 -1 -1 -1 -1 9 10 9 10 9 10 9 10
9 10 -1 -1 9 10 17 17 17 17 17 17 9 10 9 10 9 10 9 10