TILEMAP
20 15 							-- Size of tile map in tiles
32 32 							-- Tile size & block size
images/tiles.png 	-- Tilesheet
6 4 								-- Number of tiles in tilesheet
12 -1 -1 -1 -1 -1 -1 -1 -1 -1 -1 10 9 10 9 10 9 10 9 10
12 -1 14 -1 -1 11 -1 14 14 14 -1 14 14 14 14 14 -1 -1 -1 -1
12 -1 15 -1 3 10 9 -1 -1 -1 -1 -1 -1 -1 -1 -1 -1 -1 -1 -1
12 -1 -1 -1 4 10 9 -1 -1 -1 -1 -1 -1 -1 -1 -1 -1 -1 -1 -1
12 -1 -1 -1 3 10 9 -1 -1 -1 -1 -1 -1 -1 -1 -1 -1 -1 -1 -1
-1 -1 -1 -1 -1 10 9 -1 -1 -1 -1 -1 -1 -1 -1 -1 -1 -1 -1 -1
0 1 2 -1 -1 10 9 -1 -1 -1 -1 0 1 1 2 -1 -1 -1 -1 -1
-1 -1 -1 -1 -1 10 9 -1 -1 -1 -1 -1 -1 -1 -1 -1 -1 -1 -1 -1
-1 -1 -1 -1 -1 -1 -1 -1 -1 -1 -1 -1 -1 -1 -1 -1 -1 -1 11 -1
-1 -1 -1 -1 -1 -1 -1 -1 -1 -1 -1 -1 -1 -1 0 1 2 -1 -1 -1
0 1 1 1 2 -1 -1 -1 -1 -1 -1 11 -1 -1 -1 -1 -1 -1 -1 -1
9 10 9 10 9 -1 -1 -1 -1 0 1 2 -1 -1 -1 -1 -1 -1 -1 -1
9 7 7 7 9 -1 -1 -1 -1 -1 -1 -1 -1 -1 -1 -1 -1 -1 -1 -1
9 8 8 8 9 11 -1 -1 -1 -1 -1 -1 -1 -1 -1 -1 -1 -1 -1 -1
9 10 9 10 9 0 1 2 17 17 17 17 17 17 17 17 17 17 17 17
