TILEMAP
20 15 							-- Size of tile map in tiles
32 32 							-- Tile size & block size
images/tiles.png 	-- Tilesheet
6 4 								-- Number of tiles in tilesheet
10 9 10 9 10 9 10 9 10 9 10 9 10 9 10 9 10 9 10 9
10 9 -1 -1 -1 -1 -1 -1 -1 -1 -1 14 -1 14 -1 -1 -1 -1 -1 9
10 9 -1 -1 -1 -1 -1 -1 -1 -1 -1 -1 -1 -1 -1 -1 -1 -1 -1 9
10 9 -1 -1 -1 -1 -1 -1 -1 -1 -1 -1 -1 -1 -1 -1 -1 -1 -1 9
10 9 -1 -1 -1 -1 -1 -1 -1 -1 -1 -1 -1 -1 -1 -1 -1 -1 -1 9
10 9 -1 -1 -1 -1 -1 -1 -1 -1 -1 -1 -1 -1 -1 -1 -1 -1 -1 9
10 9 -1 -1 -1 -1 -1 -1 -1 -1 -1 -1 -1 -1 -1 -1 -1  0  2 9
10 9 -1 -1 -1 17 17 17 17 17 17 17 17 17 -1 -1 -1 -1 -1 9
10 9 -1  0  1 1 1 1 1 1 1 1 1 1 1  2 -1 -1 -1 9
10 9 -1 -1 -1 -1 -1 -1 10 9 -1 -1 -1 -1 -1 -1 -1 -1 -1 9
10 9 -1 -1 -1 -1 -1 -1 10 9 -1 -1 -1 -1 -1 -1 -1 -1 -1 9
10 9 -1 -1 -1 -1 -1  0 10 9 -1 -1 -1 -1 -1 -1 -1 -1 -1 9
10 9 -1 -1 -1 -1 -1 -1 10 9 -1 -1 -1 -1 -1 -1 -1 -1 -1 9
10 9 13 -1 -1 -1 -1 -1 10 9  0  2 -1 -1 -1 -1  0  2 -1 9
0 1 1 1 2 17 17 17 17 17 17 17 17 17 17 17 17 17 17 17